M----------------B-B------------------------X------------M---------------X---------------------------?----------------o---------o-X-----?---------X---------T---------X-----o----------------X-----B---o
B---X------------E-B--X----o?------X--------B----------E-----------------X---------------T--------------XE------------o-----?--o--------B---------o---------------X---?-----o----------------M---------|
E--------?o-|--?-X---------M---M--------------------------M--X-----------o----------X--------------------X------------X-------M|-----X------------B----X----------X---X--X-X|----?---------------------M
XB---X----T-M--X-|-------X----EE------X---------o-M------X---------o-----X-XX-------------------------------------------------BB-----T-E----E-----------------X----------E-o-X-X-o-X----X-----------XB-o
|M---X----E-Xo-X-oM------B----------------E-----MX?---X-----------------?--?------------------------|------X-----------------M---------o----T--|-----------|--B----?-----M----BB-E----?---------M---X-MB
X----X---EB-M---oo--X---------------------|-----X-------X--------------------o-----------------E----X--------|---------------B--------o------M-o-o---------B--M---X------X-----B------X-----X------MX---
o----|----|-o----?-------------|----------M--------o-T--?--------|-B-------------------------X------MX--o------B-T?------------E----E----X-o---T-------X---X--o----------X-----------MX-----X------X---M
E---|-----?-o--------------X---B----------B-------------BB-----------------?-------------------------B------------------------------?--X-X-----M-----------X--?------?---------------------X------X----v
B---o-----M--B--X---E----------o----------?----?-M-----------------------|---------------------o------X---------X---o------B--------o-----------T------------M|-----B----------X-----------B-B-T-------B
---B------o--X-----??----------?-----------------o-E-------------T------------o----------------T----------------X-X-------------|--B-XE---------X------------o----X-X----------M------E----------------T
E------------?------o----------M-------------------BT------------o-----------?-------B--B------B--------o---?--X-----?----------X--X--------X----------X----------X-X----------M------?---------------M|
------------X--------------------------------------o-M-----M-----------------------M-Bo-----------------X------------X-------X-X------------E------------------------------------|-----------------o--?o
X---X--X----B-----------X----o-------o--------X----T----o--------------X----B--o---B------------------E-M-X----------B------X--M-------X------X------------------X---X----------?X-------------------oX?
M-----TX-----------M-T-?B------------X------E--X------BX?-X-----T-------------|o---T--------------X---X-?------------E--X---M--X-E---?-M-?---X--?----o-------|---T---X---X---M--B|---?M------X-X-----BXE
m-----X?X----X-----B-??-X----------?M?-Bo--BX--BX---?oXXo-X----oM?--X---------?T-M|XX---XMX-----o-E--?BX?--B--oB-M|--M--BTXBXo-XXBX-oMEX-B---X--XX-B-T----o--B---E--M?T--TTo-XMEXTM-Mo--o----?-XM---|BoX
XX--XXXXXXXXXMX-XXXXXXX-X-XXXXXoXXXXXXXXXXXXXXXXXXXXXXXXBXXXX-XXXXXXXXXXX-XXXXXoXXXXXXo-XXXXXXXXXXXXXXXXXoXXXXXXXXXXXXXMXXXXXXXXXXXXXXXXXX-XXX?XXXXXXXXXXXXX-?XXXXX-XXX--XXXXXXXXXXXXX--XXX-XXXXXX-XX?XX
