-----------------------------------------------------------------------------------------------------------------------------------------------------------------------------------------M--------------
--------------------o-----------------------------------------------------------------------------------------------------------------------------------------------------------------------------------
-----------------B-------o---------------------------------------------------------------------BBB------------------------------------------------------------------------------------------------------
--------------------------------------------------------------------------------------------------o-----B-----------------------------------------------------------------------------------------------
-------------------------------------------------------------------B---------M------????????------T-----------------------------------------------------------------------------------------------------
--------------------------------------------------------------------------------------------------|--------------???????--------------------------------------------------------------------------------
--------------------------------------------------------------------------------------------------|-???????---------------------------------------------------------------------------------------------
---------------------------------------------------------------------------------------------X----|----------------------------------------------------------------------------------------------------v
--------------------------------------------------------------------------------------------------|------------------------------X-------BBBBBBBB------------------------------------------------------f
-----------------------------------------------------------------------------------------B--------|------T----------------------XX---------------------------------------------------------------------f
--o-----------------------------------------------------------------------------------------------|------|---------------------XXX--------------------------B------------------------------------------f
-------------------------X--------------------------------------------------------------------o---|------|--------------------XXXX---------------------------------------------------------------------f
------------------------XX----------------------------------------------------------o-------------|------|-------------------XXXXX---------------------------------------------------------------------f
-----------------o-----XXX-----------------------------------------------------------------X------|------|------------------XXXXXX---------------------------------------------------------------------f
m---E-------E---------XXXX---------------------------------------------------------------X------E-|------|------E--E-------XXXXXXX-----------------------------------------------?---------------------X
XXXXXXXXXXXXXXXXXXXXXXXXXXXXXXXXXXXXXXXXXXXXXXXXXXXXXXXXXXXXXXXXXXX-XXXXXXXXXXXXXXXXXXXXXXXXX----X|XXXXXX|XXXXXXX------XXXXXXXXXXX-----XXXXXXXXXXXXXXXXBXXXXXXXXXXXXXXXXXXXXXXXXXXXXXXXXXXXXXXXXXXXXXXXX
