---B----------------------------------------------------------------------------------------------------------------------------------------------------------------------------------------------------
-----------M-----------------------------------------------------------------------------------------------------------------------------------------------------------------------------------o--------
--------------------------------------------------------------------------------------------------------------------------------------------------------------------------------------------------------
--------------------------------------------------------------------------------------------------------------------------------------------------------------------------------------------------------
--------------------------------------------------------------------------------------------------------------------------------------------------------------------------------------------------------
------------------------------------------------------------------------------------------------------------------------------------X----------------------------------------?--------------------------
---------------X-------------------------------------------------------------------------------------------------------------------XX-------------------------------------------------------------------
--------------XX-T----------------------------------------------------------------------------------------------------------------XXX------------------------------------------------------------------v
-------------XXX-|---------------------------------------------------------------------------------------------------------------XXXX---------------------X--------------------------------------------f
------------XXXX-|--------------------------------------------------------------------------------------------------------------XXXXX----------------------------------X-------------------------------f
-----------XXXXX-|-------------------------------------------------------------------------------------------------------------XXXXXX----------------------------------XX------------------------------f
----------XXXXXX-|------------------------------------------------------------------------------------------------------------XXXXXXX----------------------T-----o-X---XXX-----------------------------f
---------XXXXXXX-|-----------------------------------------------------------------------------------------------------------XXXXXXXX----------------------|-----------XXXX----------------------------f
--------XXXXXXXX-|----------------------------------------------------------------------------------------------------------XXXXXXXXX----------------------|-----------XXXXX---------------------------f
m------XXXXXXXXX-|-------------------------------------------------------X-------------------------------------------------XXXXXXXXXX---E------------------|-----------XXXXXX----------------E---------X
XX----XXXXXXXXXXX|BBBXXXXXXXXXXXXXXXXXXXXXXXXXXXXXXXXXXXXXXXXXXXXXXXXXXXXXXXXXXXXXXXXXXXXXXXXXXXXXXXXXXXXXXXXXXXXXXXXXXXXXXXXXXXXXXXXXXXXXXXXXXXXXXXXXXXXXX|XXXXXXXXXXXXXXXXXXXXXXXXXXXXXXXXXXXXXXXXXXXX
