--------------------------------------------X-----------------------------------------------------------------------------------------------------------------------------------------------------------
-----------------------------------------------------------------XXXXXX---------------------------------------------------------------------------------------------------------------------------------
---M----------B-----------------------------------------------------------------------------------------------------------------------------------------------------------------------------------------
--------------------------------------------------------------------------------------------------------------------------------------------------------------------------------------------------------
-------------------o-----------------------------------------------?----?---------------????------------------------------------------------------------------------------------------------------------
-----------------------B--------------------------------------------------------------------?---------------------------------------------------------------------------M-------------------------------
------------------------------------------------------------------------o--------------o-----------------------------------------------------------------------X----------------------------------------
--------------------------------------------------------------------------------------------------------------------------------------------------------------XX---------------------------------------v
-----------------------------------------------------------------B-------------------------------------------------------------------------------------------XXX---------------------------------------f
---------------------------B--------------------------------------------------------------------------------------------------------------------------------XXXX---------------------------------------f
-----------------------------------------------------------------------------------------------------------------------------------------------------------XXXXX---------------------------------------f
--------------------------------------------------------------------------------------------------?-------------------------------------------------------XXXXXX---------------------------------------f
------------------------T------------B-------------------------------------------------------M------T----------------------------------------------------XXXXXXX---------------------------------------f
---------?--------------|---------?????-------------------------------------------------------------|---------------------------------------------------XXXXXXXX---------------------------------------f
m-----------------------|-----------------X--------------------E---------------------------X--------|----------E---------------------------------------XXXXXXXXX---------------------------------------X
XXXXXXXXXXXXXXXXXXXXXXXX|XXXXXXXXXXXXXXXXXXXXXXXXXXXXXXXXXXXXXXXXXXXXXXXXXXXXXXXXXXXXXXXXXXXXXXXXXXX|X-------XXXXXXXXXXBXXXXXXXXXXXXXXXXXXXXXXXXXXXXXXXXXXXXXXXXXXXX?XXXXXXXXXXXXXXXXXXXXXX-------XXXXXX
